
# 0th-Level Nightblade Spells:
arcane mark.MOD	CLASSES:Nightblade=0
bleed.MOD	CLASSES:Nightblade=0
detect magic.MOD	CLASSES:Nightblade=0
detect poison.MOD	CLASSES:Nightblade=0
ghost sound.MOD	CLASSES:Nightblade=0
haunted fey aspect.MOD	CLASSES:Nightblade=0
light.MOD	CLASSES:Nightblade=0
message.MOD	CLASSES:Nightblade=0
open/close.MOD	CLASSES:Nightblade=0
prestidigitation.MOD	CLASSES:Nightblade=0
ray of frost.MOD	CLASSES:Nightblade=0
read magic.MOD	CLASSES:Nightblade=0
shape shadows.MOD	CLASSES:Nightblade=0
sift.MOD	CLASSES:Nightblade=0
snuff.MOD	CLASSES:Nightblade=0
spark.MOD	CLASSES:Nightblade=0
touch of fatigue.MOD	CLASSES:Nightblade=0
# 1st-Level Nightblade Spells:
blendARG.MOD	CLASSES:Nightblade=1
blurred movement.MOD	CLASSES:Nightblade=1
cause fear.MOD	CLASSES:Nightblade=1
chill touch.MOD	CLASSES:Nightblade=1
color spray.MOD	CLASSES:Nightblade=1
comprehend languages.MOD	CLASSES:Nightblade=1
corrosive touch.MOD	CLASSES:Nightblade=1
detect secret doors.MOD	CLASSES:Nightblade=1
discern next of kin.MOD	CLASSES:Nightblade=1
disguise self.MOD	CLASSES:Nightblade=1
disguise weapon.MOD	CLASSES:Nightblade=1
ear-piercing scream.MOD	CLASSES:Nightblade=1
expeditious retreat.MOD	CLASSES:Nightblade=1
eyes of eventide.MOD	CLASSES:Nightblade=1
feather fall.MOD	CLASSES:Nightblade=1
forced quiet.MOD	CLASSES:Nightblade=1
glue seal.MOD	CLASSES:Nightblade=1
grasp of darkness.MOD	CLASSES:Nightblade=1
grease.MOD	CLASSES:Nightblade=1
hidden illumination.MOD	CLASSES:Nightblade=1
icicle dagger.MOD	CLASSES:Nightblade=1
illusion of calm.MOD	CLASSES:Nightblade=1
interrogation.MOD	CLASSES:Nightblade=1
liberating command.MOD	CLASSES:Nightblade=1
magic aura.MOD	CLASSES:Nightblade=1
memory lapse.MOD	CLASSES:Nightblade=1
mount.MOD	CLASSES:Nightblade=1
negative reaction.MOD	CLASSES:Nightblade=1
obscure object.MOD	CLASSES:Nightblade=1
obscuring mist.MOD	CLASSES:Nightblade=1
ray of enfeeblement.MOD	CLASSES:Nightblade=1
ray of sickening.MOD	CLASSES:Nightblade=1
shadow ammunition.MOD	CLASSES:Nightblade=1
shadow stream.MOD	CLASSES:Nightblade=1
shadow weapon.MOD	CLASSES:Nightblade=1
shocking grasp.MOD	CLASSES:Nightblade=1
silent image.MOD	CLASSES:Nightblade=1
touch of gracelessness.MOD	CLASSES:Nightblade=1
umbral assistant.MOD	CLASSES:Nightblade=1
undetectable alignment.MOD	CLASSES:Nightblade=1
vanish.MOD	CLASSES:Nightblade=1
ventriloquism.MOD	CLASSES:Nightblade=1
vocal alteration.MOD	CLASSES:Nightblade=1
youthful appearance.MOD	CLASSES:Nightblade=1
# 2nd-Level Nightblade Spells:
accelerate poison.MOD	CLASSES:Nightblade=2
air step.MOD	CLASSES:Nightblade=2
aggressive thundercloud.MOD	CLASSES:Nightblade=2
anonymous interaction.MOD	CLASSES:Nightblade=2
blindness/deafness.MOD	CLASSES:Nightblade=2
blur.MOD	CLASSES:Nightblade=2
brow gasher.MOD	CLASSES:Nightblade=2
bull’s strength.MOD	CLASSES:Nightblade=2
cat’s grace.MOD	CLASSES:Nightblade=2
communal eyes of eventide.MOD	CLASSES:Nightblade=2
communal mount.MOD	CLASSES:Nightblade=2
create treasure map.MOD	CLASSES:Nightblade=2
dark confinement.MOD	CLASSES:Nightblade=2
dark recovery.MOD	CLASSES:Nightblade=2
darkness.MOD	CLASSES:Nightblade=2
darkvision.MOD	CLASSES:Nightblade=2
death knell.MOD	CLASSES:Nightblade=2
detect thoughts.MOD	CLASSES:Nightblade=2
disguise other.MOD	CLASSES:Nightblade=2
dust of twilight.MOD	CLASSES:Nightblade=2
eagle’s splendor.MOD	CLASSES:Nightblade=2
enter image.MOD	CLASSES:Nightblade=2
euphoric cloud.MOD	CLASSES:Nightblade=2
extreme flexibility.MOD	CLASSES:Nightblade=2
false life.MOD	CLASSES:Nightblade=2
focused scrutiny.MOD	CLASSES:Nightblade=2
fog cloud.MOD	CLASSES:Nightblade=2
frigid touch.MOD	CLASSES:Nightblade=2
frost fall.MOD	CLASSES:Nightblade=2
ghostly disguise.MOD	CLASSES:Nightblade=2
glide.MOD	CLASSES:Nightblade=2
glitterdust.MOD	CLASSES:Nightblade=2
haunting mists.MOD	CLASSES:Nightblade=2
hidden speech.MOD	CLASSES:Nightblade=2
hypnotic pattern.MOD	CLASSES:Nightblade=2
invisibility.MOD	CLASSES:Nightblade=2
knock.MOD	CLASSES:Nightblade=2
lesser shadow conjuration.MOD	CLASSES:Nightblade=2
lesser shadow necromancy.MOD	CLASSES:Nightblade=2
locate object.MOD	CLASSES:Nightblade=2
minor image.MOD	CLASSES:Nightblade=2
mirror image.MOD	CLASSES:Nightblade=2
misdirection.MOD	CLASSES:Nightblade=2
muffle sound.MOD	CLASSES:Nightblade=2
night shield.MOD	CLASSES:Nightblade=2
pernicious poison.MOD	CLASSES:Nightblade=2
phantasmal foe.MOD	CLASSES:Nightblade=2
pilfering hand.MOD	CLASSES:Nightblade=2
protective penumbra.MOD	CLASSES:Nightblade=2
scare.MOD	CLASSES:Nightblade=2
see invisibility.MOD	CLASSES:Nightblade=2
shadow anchor.MOD	CLASSES:Nightblade=2
shadow ball.MOD	CLASSES:Nightblade=2
shadow binding.MOD	CLASSES:Nightblade=2
share memory.MOD	CLASSES:Nightblade=2
silence.MOD	CLASSES:Nightblade=2
silent table.MOD	CLASSES:Nightblade=2
sound burst.MOD	CLASSES:Nightblade=2
spider climb.MOD	CLASSES:Nightblade=2
stricken heart.MOD	CLASSES:Nightblade=2
tongues.MOD	CLASSES:Nightblade=2
twilight haze.MOD	CLASSES:Nightblade=2
umbral berserker.MOD	CLASSES:Nightblade=2
web.MOD	CLASSES:Nightblade=2
whip of spiders.MOD	CLASSES:Nightblade=2
whispering wind.MOD	CLASSES:Nightblade=2
# 3rd-Level Nightblade Spells:
adjustable disguise.MOD	CLASSES:Nightblade=3
blink.MOD	CLASSES:Nightblade=3
chain of perdition.MOD	CLASSES:Nightblade=3
clairaudience/clairvoyance.MOD	CLASSES:Nightblade=3
communal darkvision.MOD	CLASSES:Nightblade=3
communal tongues.MOD	CLASSES:Nightblade=3
contagion.MOD	CLASSES:Nightblade=3
daylight.MOD	CLASSES:Nightblade=3
deeper darkness.MOD	CLASSES:Nightblade=3
dispel magic.MOD	CLASSES:Nightblade=3
displacement.MOD	CLASSES:Nightblade=3
fear.MOD	CLASSES:Nightblade=3
fearsome duplicate.MOD	CLASSES:Nightblade=3
fly.MOD	CLASSES:Nightblade=3
gloomblind bolts.MOD	CLASSES:Nightblade=3
haste.MOD	CLASSES:Nightblade=3
howling agony.MOD	CLASSES:Nightblade=3
illusory script.MOD	CLASSES:Nightblade=3
invisibility sphere.MOD	CLASSES:Nightblade=3
lesser shadow evocation.MOD	CLASSES:Nightblade=3
lightning bolt.MOD	CLASSES:Nightblade=3
loathsome veil.MOD	CLASSES:Nightblade=3
major image.MOD	CLASSES:Nightblade=3
night terror.MOD	CLASSES:Nightblade=3
nondetection.MOD	CLASSES:Nightblade=3
pain strike.MOD	CLASSES:Nightblade=3
phantom driver.MOD	CLASSES:Nightblade=3
phantom steed.MOD	CLASSES:Nightblade=3
pierce disguise.MOD	CLASSES:Nightblade=3
ray of exhaustion.MOD	CLASSES:Nightblade=3
sands of time.MOD	CLASSES:Nightblade=3
scrying.MOD	CLASSES:Nightblade=3
secret page.MOD	CLASSES:Nightblade=3
seek thoughts.MOD	CLASSES:Nightblade=3
sensory deprivation.MOD	CLASSES:Nightblade=3
shadow courier.MOD	CLASSES:Nightblade=3
shadow form.MOD	CLASSES:Nightblade=3
shadow structure.MOD	CLASSES:Nightblade=3
shadow vortex.MOD	CLASSES:Nightblade=3
shadow wound.MOD	CLASSES:Nightblade=3
sleet storm.MOD	CLASSES:Nightblade=3
slow.MOD	CLASSES:Nightblade=3
stinking cloud.MOD	CLASSES:Nightblade=3
twilight knife.MOD	CLASSES:Nightblade=3
umbral defender.MOD	CLASSES:Nightblade=3
vampiric touch.MOD	CLASSES:Nightblade=3
vision of hell.MOD	CLASSES:Nightblade=3
wall of darkness.MOD	CLASSES:Nightblade=3
wall of nausea.MOD	CLASSES:Nightblade=3
witness.MOD	CLASSES:Nightblade=3
# 4th-Level Nightblade Spells:
air walk.MOD	CLASSES:Nightblade=4
ball lightning.MOD	CLASSES:Nightblade=4
bestow curse.MOD	CLASSES:Nightblade=4
black tentacles.MOD	CLASSES:Nightblade=4
communal nondetection.MOD	CLASSES:Nightblade=4
communal phantom steed.MOD	CLASSES:Nightblade=4
creeping ice.MOD	CLASSES:Nightblade=4
detect scrying.MOD	CLASSES:Nightblade=4
enervation.MOD	CLASSES:Nightblade=4
eyes of the void.MOD	CLASSES:Nightblade=4
feast on fear.MOD	CLASSES:Nightblade=4
greater aggressive thundercloud.MOD	CLASSES:Nightblade=4
greater darkvision.MOD	CLASSES:Nightblade=4
greater false life.MOD	CLASSES:Nightblade=4
greater invisibility.MOD	CLASSES:Nightblade=4
greater shadow ball.MOD	CLASSES:Nightblade=4
hallucinatory terrain.MOD	CLASSES:Nightblade=4
ice storm.MOD	CLASSES:Nightblade=4
illusory strike.MOD	CLASSES:Nightblade=4
illusory wall.MOD	CLASSES:Nightblade=4
legend lore.MOD	CLASSES:Nightblade=4
lesser simulacrum.MOD	CLASSES:Nightblade=4
locate creature.MOD	CLASSES:Nightblade=4
negative image.MOD	CLASSES:Nightblade=4
night armor.MOD	CLASSES:Nightblade=4
phantasmal killer.MOD	CLASSES:Nightblade=4
phantom chariot.MOD	CLASSES:Nightblade=4
rainbow pattern.MOD	CLASSES:Nightblade=4
sending.MOD	CLASSES:Nightblade=4
shadow conjuration.MOD	CLASSES:Nightblade=4
shadow necromancy.MOD	CLASSES:Nightblade=4
shadow projection.MOD	CLASSES:Nightblade=4
shadow step.MOD	CLASSES:Nightblade=4
shadow touch.MOD	CLASSES:Nightblade=4
shadowy haven.MOD	CLASSES:Nightblade=4
shocking image.MOD	CLASSES:Nightblade=4
solid fog.MOD	CLASSES:Nightblade=4
treasure stitching.MOD	CLASSES:Nightblade=4
umbral informant.MOD	CLASSES:Nightblade=4
wall of blindness/ deafness.MOD	CLASSES:Nightblade=4
wall of ice.MOD	CLASSES:Nightblade=4
# 5th-Level Nightblade Spells:
acidic spray.MOD	CLASSES:Nightblade=5
communal air walk.MOD	CLASSES:Nightblade=5
cone of cold.MOD	CLASSES:Nightblade=5
cloudkill.MOD	CLASSES:Nightblade=5
curse of the lightless.MOD	CLASSES:Nightblade=5
damnation stride.MOD	CLASSES:Nightblade=5
deathwings.MOD	CLASSES:Nightblade=5
dream.MOD	CLASSES:Nightblade=5
false vision.MOD	CLASSES:Nightblade=5
greater contagion.MOD	CLASSES:Nightblade=5
greater dispel magic.MOD	CLASSES:Nightblade=5
greater wall of darkness.MOD	CLASSES:Nightblade=5
icy prison.MOD	CLASSES:Nightblade=5
magic jar.MOD	CLASSES:Nightblade=5
major curse.MOD	CLASSES:Nightblade=5
mass pain strike.MOD	CLASSES:Nightblade=5
mirage arcana.MOD	CLASSES:Nightblade=5
mislead.MOD	CLASSES:Nightblade=5
nightmare.MOD	CLASSES:Nightblade=5
overland flight.MOD	CLASSES:Nightblade=5
persistent image.MOD	CLASSES:Nightblade=5
phantasmal web.MOD	CLASSES:Nightblade=5
possess object.MOD	CLASSES:Nightblade=5
prying eyes.MOD	CLASSES:Nightblade=5
seeming.MOD	CLASSES:Nightblade=5
shadow evocation.MOD	CLASSES:Nightblade=5
shadow field.MOD	CLASSES:Nightblade=5
shadow gate.MOD	CLASSES:Nightblade=5
shadow walk.MOD	CLASSES:Nightblade=5
suffocation.MOD	CLASSES:Nightblade=5
umbral magician.MOD	CLASSES:Nightblade=5
unwilling shield.MOD	CLASSES:Nightblade=5
vampiric shadow shield.MOD	CLASSES:Nightblade=5
void field.MOD	CLASSES:Nightblade=5
waves of fatigue.MOD	CLASSES:Nightblade=5
whip of centipedes.MOD	CLASSES:Nightblade=5
# 6th-Level Nightblade Spells:
acid fog.MOD	CLASSES:Nightblade=6
banish light.MOD	CLASSES:Nightblade=6
banish shadows.MOD	CLASSES:Nightblade=6
banshee blast.MOD	CLASSES:Nightblade=6
chain lightning.MOD	CLASSES:Nightblade=6
circle of death.MOD	CLASSES:Nightblade=6
cold ice strike.MOD	CLASSES:Nightblade=6
eyebite.MOD	CLASSES:Nightblade=6
find the path.MOD	CLASSES:Nightblade=6
freezing sphere.MOD	CLASSES:Nightblade=6
greater scrying.MOD	CLASSES:Nightblade=6
greater sensory deprivation.MOD	CLASSES:Nightblade=6
lunar veil.MOD	CLASSES:Nightblade=6
mass bull’s strength.MOD	CLASSES:Nightblade=6
mass cat’s grace.MOD	CLASSES:Nightblade=6
mass eagle’s splendor.MOD	CLASSES:Nightblade=6
mass invisibility.MOD	CLASSES:Nightblade=6
mass shadow binding.MOD	CLASSES:Nightblade=6
permanent image.MOD	CLASSES:Nightblade=6
phantasmal polymorph.MOD	CLASSES:Nightblade=6
plague storm.MOD	CLASSES:Nightblade=6
programmed image.MOD	CLASSES:Nightblade=6
project image.MOD	CLASSES:Nightblade=6
scintillating pattern.MOD	CLASSES:Nightblade=6
shadow blast.MOD	CLASSES:Nightblade=6
shadow space.MOD	CLASSES:Nightblade=6
shadow terrain.MOD	CLASSES:Nightblade=6
simulacrum.MOD	CLASSES:Nightblade=6
sonic form.MOD	CLASSES:Nightblade=6
true seeing.MOD	CLASSES:Nightblade=6
umbral nightblade.MOD	CLASSES:Nightblade=6
veil.MOD	CLASSES:Nightblade=6
waves of exhaustion.MOD	CLASSES:Nightblade=6
whip of ants.MOD	CLASSES:Nightblade=6



